1111111111111111111111111111111111111111111111111111111111111111111111111111111111111111111
1P01111100000000000000000010C111110000000000000000001C0111110000C10000000000001001111100001
1001111100000100111110000000011111000001001111100000100111110000010011111000001001111100001
1000000000000100111110000010011111000001001111100000100111110000010011111000001001111100001
10011111000001001111100000100000000000010C1111100000000000000000000011111C000000000000000E1
1111111111111111111111111111111111111111111111111111111111111111111111111111111111111111111