1111111111111
10011111001C1
1P000000C0011
1001111100011
1000C000C00E1
1111111111111