11111111111
10000C00001
10P0C1C0E01
10000C00001
11111111111