1111111111111
1E011111000E1
1P00C000C0001
1001111100001
1000C000C0001
1111111111111